__mmmmmmmm
m_mm_____m
m____mmm_m
m________m
m________m
m__#_____m
m________m
m____x__mm
mmmmmmmmmm